111111111111111
10000P000000001
101001010010001
101001001010101
100E00000C00C01
111111111111111