111111111111111111111111111111
10010000000C0010000000C0010001
1000011111000010000000C0010001
1P0011E000000010000000C0010001
10010000000C0010000000C0010001
10010000000C0010000000C0010001
10010000000C0010000000C0010001
10010000000C0011111000C0010001
10010000000C0011  1000C0010001
1111111111111111  111111111111