111111111111111111111111111111
10010000000C0010000000C0010001
1000011111000010000000C0010001
1P0011E000000010000000C0010001
10010000000C0010000000C0010001
10010000000C0010000000C0010001
10010000000C0010000000C0010001
10010000000C0010000000C0010001
10010000000C0010000000C0010001
111111111111111111111111111111