111111111111111111111111111111
10010000000C0010000000C0010001
100001111100001000000PC0010001
1E0011E000000010000000C0010001
10010000000C0010000000C0000001
10010000000C0000000000C0010001
10010000000C0010000000C0000000
10010000000C0011001000C0000001
10010000000C0011001000C0000001
111111111111111100111111111111
               1111